type octile
height 60
width 60
map
............................................................
.2222222222222222222222222222222222222222222222222222222222.
.2333333333333333333333333333333333333333333333333333333332.
.23@@@@@@@@@@@@@@@.@@@@@@@@@@@@@@@@@@.@@@@@@@@@@@@@@@@@@@32.
.23@4444444444444444444444444444444444444444444444444444@32.
.23@44444.......................................44444444@32.
.23@4445555555555555555555555555555555555555555555555444@32.
.23@4445555555555555555555555555555555555555555555555444@32.
.23@444..............................................444@32.
.23@.44@@@@@@@@@@@@@.@@@@@@@@@@@@@@@.@@@@@@@@@@@@@@@@444@32.
.23@.44@6666@.......................................@444@32.
.23@.44@6666@.....22222222222222222222222222222225.8@444@32.
.23@.44@6666@....@@@@@@@@@@@@@@@@@@@@@@@@@@@@@@@@5.8@444@32.
.23@.44@6666@....@..............................@5.8@444@32.
.23@.44@6666@....@..............................@5.8@444@32.
.23@.44@6666@....@...@@@@@@@@@@@@@@@@@@@@@@.....@5.8@444@32.
.23@.44@6666@....@...@....................@.....@5.8@444@32.
.23@.44@8.77@....@55.@...@@@@@@@@@@@@@@...@.....@5.8@444@32.
.23@.44@8.77@....@55.@...@............4...@.....@5.8@444@32.
.23@.44@8.77@....@55.@...@..@@@@@@@@..@...@.....@5.8@444@32.
.23@.44@8.77@....@55.@...@..@......@..@...@.....@5.8@444@32.
.23@.44@8.77@....@55.@...@..@...@..8..@...@.....@5.8@444@32.
.23@.44@8.77@....@55.@...@..@...@..@..@...@.....@5.8@444@32.
.23@.44@8.77@....@55.@...@..@...@..@..@...@.....@5.8@444@32.
.23@.44@8.77@....@55.@...@..@...@..@..@...@.....@5.8@444@32.
.23@.44@8.77@....@55.@...@..@@@@@..@..@...@.....@5.8@444@32.
.23@.44@8.77@....@55.@...@.........@..@...@.....@5.8@444@32.
.23..44@8.77@....@55.@...@@@@@@@@@@@..@...@.....@5.8@444.32.
.23@.44@8.77@....@55.@................@...@.....@5.8@444@32.
.23@.44@8.77@....@55.@................@...@.....@5.8@444@32.
.23@.44@8.77@....@55.@@@@@@@@@@@@@@@@@@...@.....@5.8@444@32.
.23@.44@8.77@....@55..................@...@.....@5.8@444@32.
.23@.44@8.77@....@444446666667777777777777@.....@5.8@444@32.
.23@.44@8.77@....@@@@@@@@@@@@@@@@@@@@@@@@@@.....@5.8@444@32.
.23@.44@8.77@.....666666666666666666666666666666@5.8@444@32.
.23@.44@8.77@....@666666666666666666666666666666@5.8@444@32.
.23@.44@8.77@....@..............................@5.8@444@32.
.23@.44@8.77@@@@@@@@@@@@@@@@@@@@.@@@@@@@@@@@@@..@5.8@444@32.
.23@.44@.....................................@..@5.8@444@32.
.23@.44@.....................................@..@5.8@444@32.
.23@.44@....@@@@@@@@@@@@@@@@@@@@@@@@@@@@@@...@..@5.8@444@32.
.23@.44@....@............................@...@..@5.8@444@32.
.23@.44@....@55..........................@...@..@5.8@444@32.
.23@.44@....@55.@@@@@@@@@@@@@@@@@@@@@....@...@..@5.8@444.32.
.23@.44@....@55.@...................@....@...@..@5.8@444@32.
.23..44@....@55.@5555555555555555555@....@...@..@5.8@444@32.
.23@.44@....@55.@5555555555555555555@....@...@..@5.8@444@32.
.23@.44@....@55.@....@@@@@@@@@@@@@@@@....@...@..@5.8@444@32.
.23@.44@....@55.@........................@...@..@5.8@444@32.
.23@.44@....@55.@........................@...@..@5.8@444@32.
.23@.44@....@55.@@@@@@@@@@@@@@@@@@@@@@@@@@...@..@5.8@444@32.
.23@.44@....@55.....777777777777777777.......@..@5.8@444@32.
.23@.44@....@55..888888888.....66666664444444@..@5.8@444@32.
.23@.44@....@@@@@@@@@@@@@@@@@@@@@@@@@@@@@@@@@@..@5.8@444@32.
.23@444@444444444444444444444444444444444444444444444444@32.
.23@444@444444444444444444444444444444444444444444444444@32.
.23@@@@@@@@@@@@.@@@@@@@@@@@@@@@@@@@@@@@@.@@@@@@@@@......@32.
.2333333333333333333333333333333333333333333333333333333332.
.2222222222222222222222222222222222222222222222222222222222.
............................................................