1B1B1B1B1B1B1B1B1B1B1B1B1B1B1B1B1B1B1B1B1B1B1B1B1B1B1B1B1B1B
B1B1B1B1B1B1B1B1B1B1B1B1B1B1B1B1B1B1B1B1B1B1B1B1B1B1B1B1B1B1
1B1B1B1B1B1B1B1B1B1B1B1B1B1B1B1B1B1B1B1B1B1B1B1B1B1B11111B1B
B1B1B1B1B1B1B1B1B1B1B1B1B1B1B1B1B1B1B1B1B1B1B1B1B1B11111B1B1
1B1B1B1B1B1B1B1B1B1B1B1B1B1B1B1B1B1B1B1B1B1B1B1B1B11111B1B1B
B1B1B1B1B1B1B1B1B1B1B1B1B1B1B1B1B1B1B1B1B1B1B1B1B1B1B111B1B1
1B1B1B1B1B1B1B1B1B1B1B1B1B1B1B1B1B1B1B1B1B1B1B1B1B1B1B111B1B
B1B1B1B1B1B1B1B1B1B1B1B1B1B1B1B1B1B1B1B1B1B1B1B1B1B1B11111B1
1B1B1B1B1B1B1B1B1B1B1B1B1B1B1B1B1B1B1B1B1B1B1B1B1B1B111B1B1B
B1B1B1B1B1B1B1B1B1B1B1B1B1B1B1B1B1B1B1B1B1B1B1B1B1B1B1B1B1B1
1B1B1B1B1B1B1B1B1B1B1B1B1B1B1B1B1B1B1B1B1B1B1B1B1B1B111B1B1B
B1B1B1B1B1B1B1B1B1B1B1B1B1B1B1B1B1B1B1B1B1B1B1B1B1B1B1B1B1B1
1B1B1B1B1B1B1B1B1B1B1B1B1B1B1B1B1B1B1B1B1B1B1B1B1B1B111B1B1B
B1B1B1B1B1B1B1B1B1B1B1B1B1B1B1B1B1B1B1B1B1B1B1B1B1B111B1B1B1
1B1B1B1B1B1B1B1B1B1B1B1B1B1B1B1B1B1B1B1B1B1B1B1B11111B1B1B1B
B1B1B1B1B1B1B1B1B1B1B1B1B1B1B1B1B1B1B1B1B1B1B1B111B111B1B1B1
1B1B1B1B1B1B1B1B1B1B1B1B1B1B1B1B1B1B1B1B1B1B1B111B1B1B1B1B1B
B1B1B1B1B1B1B1B1B1B1B1B1B1B1B1B1B1B1B1B1B1B1B1B1B1B1B1B1B1B1
1B1B1B1B1B1B1B1B1B1B1B1B1B1B1B1B1B1B1B1B1B1B1B111B1B1B1B1B1B
B1B1B1B1B1B1B1B1B1B1B1B1B1B1B1B1B1B1B1B1B1B1B111B1B1B1B1B1B1
1B1B1B1B1B1B1B1B1B1B1B1B1B1B1B1B1B1B1B1B1B1B111B1B1B1B1B1B1B
B1B1B1B1B1B1B1B1B1B1B1B1B1B1B1B1B1B1B1B1B1B111B1B1B1B1B1B1B1
1B1B1B1B1B1B1B1B1B1B1B1B1B1B1B1B1B1B1B1B1B111B1B1B1B1B1B1B1B
B1B1B1B1B1B1B1B1B1B1B1B1B1B1B1B1B1B1B1B1B111B1B1B1B1B1B1B1B1
1B1B1B1B1B1B1B1B1B1B1B1B1B1B1B1B1B1B1B1B111B1B1B1B1B1B1B1B1B
B1B1B1B1B1B1B1B1B1B1B1B1B1B1B1B1B1B1B1B111B1B1B1B1B1B1B1B1B1
1B1B1B1B1B1B1B1B1B1B1B1B1B1B1B1B1B1B1B111B1B1B1B1B1B1B1B1B1B
B1B1B1B1B1B1B1B1B1B1B1B1B1B1B1B1B1B1B111B1B1B1B1B1B1B1B1B1B1
1B1B1B1B1B1B1B1B1B1B1B1B1B1B1B1B1B1B111B1B1B1B1B1B1B1B1B1B1B
B1B1B1B1B1B1B1B1B1B1B1B1B1B1B1B1B1B1B1B1B1B1B1B1B1B1B1B1B1B1
1B1B1B1B1B1B1B1B1B1B1B1B1B1B1B1B1B1B1B1B1B1B1B1B1B1B1B1B1B1B
B1B1B1B1B1B1B1B1B1B1B1B1B1B1B1B1B1B111B1B1B1B1B1B1B1B1B1B1B1
1B1B1B1B1B1B1B1B1B1B1B1B1B1B1B1B1B1B1B1B1B1B1B1B1B1B1B1B1B1B
B1B1B1B1B1B1B1B1B1B1B1B1B1B1B1B11111B1B1B1B1B1B1B1B1B1B1B1B1
1B1B1B1B1B1B1B1B1B1B1B1B1B1B1B111B1B1B1B1B1B1B1B1B1B1B1B1B1B
B1B1B1B1B1B1B1B1B1B1B1B1B1B1B111B1B1B1B1B1B1B1B1B1B1B1B1B1B1
1B1B1B1B1B1B1B1B1B1B1B1B1B1B111B1B1B1B1B1B1B1B1B1B1B1B1B1B1B
B1B1B1B1B1B1B1B1B1B1B1B1B1B111B1B1B1B1B1B1B1B1B1B1B1B1B1B1B1
1B1B1B1B1B1B1B1B1B1B1B1B1B111B1B1B1B1B1B1B1B1B1B1B1B1B1B1B1B
B1B1B1B1B1B1B1B1B1B1B1B11111B1B1B1B1B1B1B1B1B1B1B1B1B1B1B1B1
1B1B1B1B1B1B1B111B1111111B1B1B1B1B1B1B1B1B1B1B1B1B1B1B1B1B1B
B1B1B1B1B1B1B111111111B1B1B1B1B1B1B1B1B1B1B1B1B1B1B1B1B1B1B1
1B1B1B1B1B1B1B1B1B1B1B1B1B1B1B1B1B1B1B1B1B1B1B1B1B1B1B1B1B1B
B1B1B1B1B1B1B111B1B1B1B1B1B1B1B1B1B1B1B1B1B1B1B1B1B1B1B1B1B1
1B1B1B1B1B1B111B1B1B1B1B1B1B1B1B1B1B1B1B1B1B1B1B1B1B1B1B1B1B
B1B1B1B1B1B1B111B1B1B1B1B1B1B1B1B1B1B1B1B1B1B1B1B1B1B1B1B1B1
1B1B1B1B1B1B111B1B1B1B1B1B1B1B1B1B1B1B1B1B1B1B1B1B1B1B1B1B1B
B1B1B1B1B1B1B111B1B1B1B1B1B1B1B1B1B1B1B1B1B1B1B1B1B1B1B1B1B1
1B1B1B1B1B1B111B1B1B1B1B1B1B1B1B1B1B1B1B1B1B1B1B1B1B1B1B1B1B
B1B1B1B1B1B11111B1B1B1B1B1B1B1B1B1B1B1B1B1B1B1B1B1B1B1B1B1B1
1B1B1B1B1B111B1B1B1B1B1B1B1B1B1B1B1B1B1B1B1B1B1B1B1B1B1B1B1B
B1B1B111B11111B1B1B1B1B1B1B1B1B1B1B1B1B1B1B1B1B1B1B1B1B1B1B1
1B1B1111111B1B1B1B1B1B1B1B1B1B1B1B1B1B1B1B1B1B1B1B1B1B1B1B1B
B1B1B1B1B1B1B1B1B1B1B1B1B1B1B1B1B1B1B1B1B1B1B1B1B1B1B1B1B1B1
1B1B111B1B1B1B1B1B1B1B1B1B1B1B1B1B1B1B1B1B1B1B1B1B1B1B1B1B1B
B1B111B1B1B1B1B1B1B1B1B1B1B1B1B1B1B1B1B1B1B1B1B1B1B1B1B1B1B1
1B1B1B1B1B1B1B1B1B1B1B1B1B1B1B1B1B1B1B1B1B1B1B1B1B1B1B1B1B1B
B1B111B1B1B1B1B1B1B1B1B1B1B1B1B1B1B1B1B1B1B1B1B1B1B1B1B1B1B1
11111B1B1B1B1B1B1B1B1B1B1B1B1B1B1B1B1B1B1B1B1B1B1B1B1B1B1B1B
B1B1B1B1B1B1B1B1B1B1B1B1B1B1B1B1B1B1B1B1B1B1B1B1B1B1B1B1B1B1
