type octile
height 81
width 81
map
4336749.27932494873285945.82.23878886.326..4675397668276478323532587578.456849596
2994.2947536.764369698293.9.4.465598895522..398.859846924576536349453496974.4.494
49.72565332236.7226587979695662.6394439464858.7487.7228838647865966867396.3.57585
629862.324732..46944.22426..9963647743595..687.932782294275358486266.44.963.797.4
988387396562363.643972773497462842658.575654563.236222247248769867425286734537448
99.53276544.88328.7474227278.6754446496.9282.9279443.6256.3745@@@@@@@@@@@@@897823
284474..98585758294757742929.974779.684..8457859837238497296.@@79764459635@@@9247
962844925558276545422726.7.5.558.9335857426727..623694866442@@88556969.2.869@@.96
33674539.74.93577.636928899454.3533..62655.462488838539.427@@28.452.8.8256544@@36
9882.588558.228834.249.773588.2992.9388.642677385433987.583@93653655.53784857.5@5
243925946964.44.674542847.5.334.82695974.589529..893298764@@758873@@@@@@2.86458@4
58455.3935.958485659.75892468787.475327.55.52546.75238.995@335748@@8869@@@69288@7
6466.95764722346..89939..64854586892896.732345657887423876@962266@7446883@@65.9@.
99.76.356587644363..69866673229933234925645823633225879667@449577@28872699@@.65@2
5642296.8226.3592257865.4.7.79826859934324833223222.7.497@@49374.@5..276545@2.9@3
84264863868478.37648966333892938927385353753769683.964.5.@47.4943@55748.356@489@5
425954555549..66392.989.4352739822.84.2888494427442742744@75.568.@544888475@@43@3
5233925.2278.275329864.6.5299.495674493579648449623826359@.9539.9@48.6775746@94@@
2362..325494.53.96.987.5.623.9.3528875487456.47742..78783@...92.2@2256335366@767@
9.4584.3455.7257896.9.949444685266535434..478755675.84697@7462558@67.585894@@465@
652479664478.689984275277574692493.9.7626.832943276.86489@368.9545@3342682335348@
4439.47935734.354.5524.7.79953975938694584.9394352963834.@6.7486..@96446455222.5@
79893.77935495332666.4.8999437595..4628.449845.66363..896@5892..867@9.378556428@@
845337.5636246477577.4644447974655524597538957866679484294@9764.6579@3524899362@3
269523233729428.7.95479.75648.578624.935945969767595397897@62.254283@@@79585.@@32
5.929774442679747727984.2855485765574.99.4666695.932472232@@85846392..6@@@@@@@853
2634568946482447852732894266.256395325.483357529.4426.79476@@78.88957792729272658
996682546536536234.392422..62483.846537648469784948943592575@@9.99373894863565847
25534.4654..8.864825522.358378@58387768768.882.997.226...5337@@246399725878944765
796.4.533252878667..9.45567459@@@564244888.32336.35.6353952579@@349732285.6657963
975426667659925255828.2336659.37@373833797582665589..6.32452474@@675223843.945268
4673882862782.9.365885.4485855439@@25662..4.9925696343.87.8742698@@@@438567994643
22694.42262948526785859268.7239234@44679868.6.73599.6787.5.55322232.@@@@463398456
28334.5289997257796836789874..4759@@75874.93448467375757397346752.38856@@4.39.554
.3558.32..926.84834393337295.2.96.2@8972586478927599598.75438455259897.4@@9967656
93.922299.6.8825..77..56.2599276389@4955428227869525.59.5729.5237.5.66634@4756934
672989464.5846743279.38252.437469.3@7784947.787836724665946263276.3342875@867.284
676322.9597.58846364349.68836737788@.977228797453.49964383545.7783.274265@6499295
4.4797848368..99855873724762..89369@36799388448399252635477..8672575..293@7488..2
85..3725436264986589.5..6439.7294.7@673.298876548..5.69.7.38348487352.974@2332245
6..6457.292496668.7.2679.8487568.62@9.69337335.4436@@@@@@@56587.922537.67@9959394
8596822997..539776273428.559.5.76.@2263.25846.29@@@.45295@@@7778795297279@7...744
63788294996.77823.5447394499.46.24@7753494.5537@@23564.5976@@572934695.47@8968886
77727467383982728584738.5.873326.8@58843754.7.@@6.75299773859@@2356263336@8267.56
57338866638752832.8245269872657945@56357825289@456.9232526.699@4635593445@948.663
8.453225693326.4947745352.88997.9@@.347437775@93599437392.6873@@325788992@6967293
227.65628.3.789868..5879997242855@5845453825@@62.35668796.63559@542364.5.@3.57586
6.25.9.96522224779442369438..9363@5.28286.5@@9462.87555.4964.57@5.4432735@..25222
82872.289.977567264.73954.9.8535@@95.854357@783.435857784295585@277433..2@6422437
73.83885755575747443372923224727@7865359949@83.3574279.74.87927@422965587@2497837
2245.359587826.599933228445.782@@6746569792@3382558538459535745@2.987.748@2884383
89645.79.39.932743762888.67392@@37779232568@5695.98..7883725835@4438.9262@2527353
4784677899.8455.52644.9957427@@26363..389.5@884.38953.52654.69.@.6836385.@2855477
.452349739..69283277753827676@2.22.7.237828@7497955353965639464@229284273@2693936
37.3.277777926877352832444992@4378276..7695@85.68474.7873654823@797976736@7575666
75638887.55244795737.4.798435@9372763843733@.786585292376278939@2.994.96@49388932
395..242.6.396.547573.7277.93@7877448768565@@7.2795585545768744@29667486@976.5726
484.57669264247.382.629963974@24..88642.6539@8.9842879829.5.239@@528@@@@22.979278
8274826633255933278..63.66463@@3952985328354@9..3..7234.25744386@@@@258556463.66.
6.692988288895296924954.463.74@665.475598.72@@9539.9782.5686982593..3795243325967
87228698798655563.8468623.7725@.5497.96.7.733@@3422898283658283848736572932943976
2.89327.3432825285256738668278@23978632444.842@@372598934428784946.84454899.72.4.
.9578263.8955.578552.5398.95872@48.747825.762639@@@@@77.2497599373455569797.55298
925289346598.394923943577258883@7579227.336342.2425.@@@@@@@@@@@@@.4743994633..223
54846445.8523.9859295599...872.2@77987542.874.863.823957253335236@@@@@29326279343
894.47.6535943429829.23598964956@75.4.4748755968676689954638857776435@@88...55355
6873442.758343.324329248299629.76@5895795878529853.83545727735682.7726@.852.44796
853.442329..3753779543769823529323@@36438684536449692.3472385946697939@54.6826837
8..738.35469.35.237.3658977456493.3@@.528.993.4372474784.246784742.568@7692884255
356649464496523.3687.8924.9397688782@@748964.28.94643567.75958...66462@.6836649.8
73.373887.35294.98.6369254.87898924.4@@@@727.95.5.92976.6756734593455@67922648928
267339976876722693672..3.5877389.4965.896@@@@547.558.728487944757377@@968928.36..
9336264.5.2339299.84.745936276..69.84399.59384@@@@@8@@@695237994@@@@634783.532..4
6354498824.7.473738.579.44783369533.337226.862422445..4@.@2@@@@@@5388774342935.5.
885784.45232448.238..5326229.439.722.552247443527867445656765.4942933553785687729
8684.885566679362.63.99389586743247.7389947.456637636775.9.27574729.8445745463962
693.793.845363633546223897946.62637764482554.373758.27755.78694655336727.6936738.
89.7798473.4224684794.774.6878953987324752242365.62343549.544975..496798246725..5
83436..43..767249.48866.37858477642.9777242.5.49935876.372294.9224339.76..87.3.64
8.765636687.3.347.45673794275569369.8..4896797778352.656..67464.3.293796.29696274
58946658666253639737676362.729688937.873944875.9337.4687397428243962347.574527368
