111111111111111111111111111111111111111111111111111111111111
122222222222222222222222222222222222222222222222222222222221
123333333333333333333333333333333333333333333333333333333321
123BBBBBBBBBBBBBBB1BBBBBBBBBBBBBBBBBB1BBBBBBBBBBBBBBBBBBB321
123B4444444444444444444444444444444444444444444444444444B321
123B4444411111111111111111111111111111111111111144444444B321
123B4445555555555555555555555555555555555555555555555444B321
123B4445555555555555555555555555555555555555555555555444B321
123B4441111111111111111111111111111111111111111111111444B321
123B144BBBBBBBBBBBBB1BBBBBBBBBBBBBBB1BBBBBBBBBBBBBBBB444B321
123B144B6666B111111111111111111111111111111111111111B444B321
123B144B6666B111112222222222222222222222222222222518B444B321
123B144B6666B1111BBBBBBBBBBBBBBBBBBBBBBBBBBBBBBBB518B444B321
123B144B6666B1111B111111111111111111111111111111B518B444B321
123B144B6666B1111B111111111111111111111111111111B518B444B321
123B144B6666B1111B111BBBBBBBBBBBBBBBBBBBBBB11111B518B444B321
123B144B6666B1111B111B11111111111111111111B11111B518B444B321
123B144B8177B1111B551B111BBBBBBBBBBBBBB111B11111B518B444B321
123B144B8177B1111B551B111B1111111111114111B11111B518B444B321
123B144B8177B1111B551B111B11BBBBBBBB11B111B11111B518B444B321
123B144B8177B1111B551B111B11B111111B11B111B11111B518B444B321
123B144B8177B1111B551B111B11B111B11811B111B11111B518B444B321
123B144B8177B1111B551B111B11B111B11B11B111B11111B518B444B321
123B144B8177B1111B551B111B11B111B11B11B111B11111B518B444B321
123B144B8177B1111B551B111B11B111B11B11B111B11111B518B444B321
123B144B8177B1111B551B111B11BBBBB11B11B111B11111B518B444B321
123B144B8177B1111B551B111B111111111B11B111B11111B518B444B321
1231144B8177B1111B551B111BBBBBBBBBBB11B111B11111B518B4441321
123B144B8177B1111B551B1111111111111111B111B11111B518B444B321
123B144B8177B1111B551B1111111111111111B111B11111B518B444B321
123B144B8177B1111B551BBBBBBBBBBBBBBBBBB111B11111B518B444B321
123B144B8177B1111B55111111111111111111B111B11111B518B444B321
123B144B8177B1111B444446666667777777777777B11111B518B444B321
123B144B8177B1111BBBBBBBBBBBBBBBBBBBBBBBBBB11111B518B444B321
123B144B8177B11111666666666666666666666666666666B518B444B321
123B144B8177B1111B666666666666666666666666666666B518B444B321
123B144B8177B1111B111111111111111111111111111111B518B444B321
123B144B8177BBBBBBBBBBBBBBBBBBBB1BBBBBBBBBBBBB11B518B444B321
123B144B1111111111111111111111111111111111111B11B518B444B321
123B144B1111111111111111111111111111111111111B11B518B444B321
123B144B1111BBBBBBBBBBBBBBBBBBBBBBBBBBBBBB111B11B518B444B321
123B144B1111B1111111111111111111111111111B111B11B518B444B321
123B144B1111B5511111111111111111111111111B111B11B518B444B321
123B144B1111B551BBBBBBBBBBBBBBBBBBBBB1111B111B11B518B4441321
123B144B1111B551B1111111111111111111B1111B111B11B518B444B321
1231144B1111B551B5555555555555555555B1111B111B11B518B444B321
123B144B1111B551B5555555555555555555B1111B111B11B518B444B321
123B144B1111B551B1111BBBBBBBBBBBBBBBB1111B111B11B518B444B321
123B144B1111B551B111111111111111111111111B111B11B518B444B321
123B144B1111B551B111111111111111111111111B111B11B518B444B321
123B144B1111B551BBBBBBBBBBBBBBBBBBBBBBBBBB111B11B518B444B321
123B144B1111B55111117777777777777777771111111B11B518B444B321
123B144B1111B55118888888881111166666664444444B11B518B444B321
123B144B1111BBBBBBBBBBBBBBBBBBBBBBBBBBBBBBBBBB11B518B444B321
123B444B444444444444444444444444444444444444444444444444B321
123B444B444444444444444444444444444444444444444444444444B321
123BBBBBBBBBBBB1BBBBBBBBBBBBBBBBBBBBBBBB1BBBBBBBBB111111B321
123333333333333333333333333333333333333333333333333333333321
122222222222222222222222222222222222222222222222222222222221
111111111111111111111111111111111111111111111111111111111111
