11111111111111111111
11BBBBBB1111111BB111
11B1111BB111BBBBBBB1
11B11111BB11B11111B1
11B1B1111B11B1BBB1B1
11B1B111B111BB11B1B1
11B1B111B1111111B1B1
11BBB11BB1111111BBB1
111BB11B11111111BBB1
11BBB11BBBBBBBBBB1B1
11B1B1111111111111B1
11B1B1111111111111B1
11B1BBBBBBBBBBBBB1B1
1BB1111111111111B1B1
1B11111111111111B1B1
1BB1111111111111B1B1
11BBB11111111111B1B1
11111BBBBBBBBBBBB1B1
11111111111111BB11B1
11111111111111111111
